#file name  language  country   variant
arabat.gim	ar	--	ATeX
arabmlt.gim	ar	--	MLT Arabic
arabwin.gim	ar	--	Windows
armstd.gim	hy	--	Standard
ascii.gim	en	--	ASCII
bengali.gim	bn	--	Inscript
msgerman.gim	de	--	Windows
georghei.gim	ka	--	Heinecke
georgim.gim	ka	--	Imnaishvili Arrangement
georgmlt.gim	ka	--	MLT
greek.gim	el	--	XTerm
greekwin.gim	el	--	Windows
hebrew.gim	he	--	Standard
hindiins.gim	hi	--	Inscript
hindivoa.gim	hi	--	VOA
tcode.gim	ja	--	TCode
hangul.gim	ko	--	Standard Hangul
2901-94.gim	fa	--	ISIRI\ 2901-94
crlpers.gim	fa	--	CRL Phonetic
crlurdu.gim	pk	--	CRL Urdu
yawerty.gim	ru	--	YAWERTY (Phonetic)
yawerty1.gim	ru	--	CRL YAWERTY (Phonetic)
sercroc.gim	sh	--	Cyrillic MLT
sercrol.gim	sh	--	Latin MLT
viet.gim	vi	--	VIQR Implicit
vietalt.gim	vi	--	VIQR Implicit (Decomposed)
vntelex.gim	vi	--	Telex
